20 30 30 30 30 30 30 30 30 20
1  1  30 30 30 1  30 1  30 30
30 1  30 30 1  30 30 30 1  30
30 1  30 1  30 30 30 30 30 30
30 30 30 1  30 1  1  1  1  30
1  30 30 30 30 30 30 30 30 30
30 30 1  30 30 30 30 30 30 30
1  30 30 30 1  1  30 1  30 30
30 30 1  30 30 30 30 30 1  30
20 30 30 30 30 30 30 30 1  20