01 01 01 01 01 01 01 01 01 01 01 01
01 00 00 00 00 00 00 00 00 00 00 01
01 00 20 00 00 00 01 00 00 00 33 01
01 00 00 00 00 00 01 01 00 00 00 01
00 00 00 00 00 00 01 01 00 00 00 01
00 00 00 00 00 00 00 00 00 00 00 01
00 00 00 00 00 00 00 00 00 00 00 01
00 00 00 00 00 00 00 00 00 00 00 01
00 00 00 00 00 00 00 00 00 10 00 01
01 00 00 00 00 00 00 30 00 00 00 01
01 00 00 00 00 00 00 00 00 00 00 01
01 01 01 01 01 01 01 01 01 01 01 01