20 00 00 00 00 00 00 00 00 00 00 20
01 02 02 00 02 00 01 01 02 01 02 00
00 00 00 00 01 00 32 00 00 00 00 00
00 01 02 00 02 00 02 01 00 01 00 00
00 02 00 00 00 00 00 00 00 02 00 02
00 00 00 01 10 33 02 01 02 00 00 20
00 02 30 00 02 02 11 00 00 00 00 02
00 01 01 02 00 00 00 01 00 01 00 00
00 00 00 00 00 02 01 31 00 00 00 00
00 01 00 01 00 01 00 00 02 01 00 00
00 02 02 02 00 00 00 00 00 01 02 00
20 00 00 00 00 02 00 00 00 00 00 20