20 00 00 00 00 00 00 00 00 00 00 20
00 01 00 01 33 00 01 02 00 02 01 00
00 01 00 00 00 00 02 32 00 00 02 00
00 01 00 01 00 00 00 00 01 00 00 00
00 01 00 00 00 00 02 00 00 00 02 00
00 01 01 01 00 10 01 02 00 02 01 00
00 00 00 00 00 00 11 00 00 00 00 00
00 01 01 00 31 00 00 00 01 01 00 00
00 00 00 00 00 00 01 00 00 01 00 00
00 00 01 01 01 00 00 00 00 01 00 00
00 00 00 30 01 01 01 00 00 00 00 00
20 00 00 00 00 00 00 00 01 01 00 20