20 00 00 00 00 10 02 00 00 00 20 20
00 01 00 01 00 00 02 02 02 02 00 00
00 01 00 01 00 02 00 00 00 02 30 00
00 01 00 01 00 00 00 02 00 02 00 00
00 01 32 00 33 02 00 00 00 00 00 00
00 00 00 00 00 00 02 02 02 02 00 00
01 00 00 00 20 00 20 00 00 02 00 00
00 00 01 00 31 00 00 00 00 00 00 00
01 00 00 00 00 00 01 00 00 00 00 20
00 00 01 01 01 00 00 00 00 01 00 00
00 00 00 00 01 01 01 00 00 00 00 00
20 00 00 00 00 00 00 00 01 01 00 10