02 00 00 00 00 00 00 00 01 00 00 00
00 20 02 00 02 00 02 00 31 00 01 00
00 02 00 00 00 00 00 02 00 01 20 00
00 00 00 02 00 02 00 02 00 10 01 00
00 01 00 00 11 00 00 00 00 01 00 00
00 00 00 02 33 02 00 02 00 00 20 02
00 01 00 00 02 00 20 02 00 01 00 00
00 00 01 00 00 00 02 32 00 00 01 00
00 00 00 00 02 00 00 02 00 00 00 00
00 01 01 00 00 02 00 00 02 02 00 01
00 20 01 00 00 02 02 00 30 02 00 01
00 00 00 00 00 00 00 00 00 00 00 01